G G G G G G G G G G G G G G G G G G G G
G G G G G G G G G G G G G G G G G G G G
G G G G G G G G G G G G G G G G G G G G
G G G G G G G G G G G G G G G G G G G G
G G G G G G G G G G G G G G G G G G G G
G G G G G G G G G G G G G G G G G G G G
G G G G G G G G G G H H H H H H H H H G
G G G G G G G G G G l W W W W W W W r G
G G G G G G G G G G l W W W W W W W r G
G G G G G G G G G G N B B B D B B B M G
G G G G G G G G G G G S G G G G G G G G
G G G G G G G G G G G G G G G G G G G G
G G G G G G G G G G G G G G L R G G G G
G G G G G G G G G G G G G G O P G G G G
G G G G G G G G G G G G G G G G G G G G
